+---------------------------------------------------------------------------------+---------------------------+
|               |++     |   |  |  | |  |  |  |  |  |  |                             |                         |
| S             |///// |  |  | |  |  |  |  |  |  |                             |                              |
|               |                                                                 |                           |
|               |     |   |  |  | |  |  |  |  |  |  |                             |                           |
|               |     |   |  |  | |  |  |  |  |  |  |                             |                           |
|               |     |   |  |  | |  |  |  |  |  |  |                             |                           |
|               |     |   |  |  | |  |  |  |  |  |  |                             |                           |
|               |     |   |  |  | |  |  |  |  |  |  |                             |                           |
|               |     |   |  |  | |  |  |  |  |  |  |                             |                           |
|               |     |   |  |  | |  |  |  |  |  |  |                             |                           |
|               |     |   |  |  | |  |  |  |  |  |  |                             |                           |
|               |     |   |  |  | |  |  |  |  |  |  |                             |                           |
|               |     |   |  |  | |  |  |  |  |  |  |                             |                           |
|               |     |   |  |  | |  |  |  |  |  |  |                             |                           |
|               |     |   |  |  | |  |  |  |  |  |  |                             |                           |
|               |     |   |  |  | |  |  |  |  |  |  |                             |                           |
|               |     |   |  |  | |  |  |  |  |  |  |                             |                           |
|               |     |   |  |  | |  |  |  |  |  |  |                             |                           |
|               |     |   |  |  | |  |  |  |  |  |  |                             |                           |
|               |     |   |  |  | |  |  |  |  |  |  |                             |                           |
|               |     |   |  |  | |  |  |  |  |  |  |                             |                           |
|               |     |   |  |  | |  |  |  |  |  |  |                             |                           |
|               |     |   |  |  | |  |  |  |  |  |  |                             |                           |
|               |     |   |  |  | |  |  |  |  |  |  |                             |                           |
|               |     |   |  |  | |  |  |  |  |  |  |                             |                           |
|               |     |   |  |  | |  |  |  |  |  |  |                             |                           |
+---------------------------------------------------------------------------------+---------------------------+
