+------------------------------------------------------------------+
|   +----------+           +-----------+       +----+              |
|   |⊟⊟⊟       |           |           |       |    |              |
|   |⊟         |                       |       |    |              |
|   |⊟⊟        T           |           |       |    |              |
|   |          |           |           |       |    |              |
|   +----------+           +-----------+       +----+              |
|   +----------+                               + ---+              |
|   |         ⊟|           +-----------+       |    |              |
|   |          |  ⁘⊔       |           |       |    |              |
|   |          T           ?           |       |    |              |
|   |          |           |           T                           |
|   +----------+           +-----------+       +----+              |
|   +----------+           +-----------+       +----+              |
|   |          |           |           |       |    |              |
|   |          |                       |       |    |              |
|   |          T           |           |       |    |              |
|   |          |           |           |       |    |              |
|   +----------+           +-----------+       +    +              |
|                                                                  |
+------------------------------------------------------------------+
